ENTER: ROW: 3, COL: 1
ENTER: ROW: 7, COL: 70
XXXXXXXXXXXXXXXXXXXXXXXXXXXXXXXXXXXXXXXXXXXXXXXXXXXXXXXXXXXXXXXXXXXXXX
XXXXXXXXXXXXXXXXXXXXXXXXXXXXXXXXXXX    XXXXXXXXXXXXXXXXXXXXXXXXXXXXXXX
  XXXXXXXXXXXXXXXXXXXXXXXXXXXXXXXX  XX  XXXXXXXXXXXXXXXXXXXXXXXXXXXXXX
X  XXXXXXXXXXXXXXXXXXXXXXXXXXXXXX  XXXX  XXXXXXXXXXXXXXXXXXXXXXXXXXXXX
XX  XXXXXXXXXXXXXXXXXXXXXXXXXXXX  XXXXXX  XXXXXXXXXXXXXXXXXXXXXXXXXXXX
XXX  XXXXXXXXXXXXXXXXXXXXXXXXXX  XXXXXXXX  XXXXXXXXXXXXXXXXXXXXXXXXXXX
XXXX  XXXXXXXXXXXXXXXXXXXXXXXX  XXXXXXXXXX  XXXXXXXXXXXXXXXXXXXXXXXX  
XXXXX  XXXXXXXXXXXXXXXXXXXXXX  XXXXXXXXXXXX  XXXXXXXXXXXXXXXXXXXXXX  X
XXXXXX  XXXXXXXXXXXXXXXXXXXX  XXXXXXXXXXXXXX  XXXXXXXXXXXXXXXXXXXX  XX
XXXXXXX  XXXXXXXXXXXXXXXXXX  XXXXXXXXXXXXXXXX  XXXXXXXXXXXXXXXXXX  XXX
XXXXXXXX  XXXXXXXXXXXXXXXX  XXXXXXXXXXXXXXXXXX  XXXXXXXXXXXXXXXX  XXXX
XXXXXXXXX  XXXXXXXXXXXXXX  XXXXXXXXXXXXXXXXXXXX  XXXXXXXXXXXXXX  XXXXX
XXXXXXXXXX  XXXXXXXXXXXX  XXXXXXXXXXXXXXXXXXXXXX  XXXXXXXXXXXX  XXXXXX
XXXXXXXXXXX  XXXXXXXXXX  XXXXXXXXXXXXXXXXXXXXXXXX  XXXXXXXXXX  XXXXXXX
XXXXXXXXXXXX  XXXXXXXX  XXXXXXXXXXXXXXXXXXXXXXXXXX  XXXXXXXX  XXXXXXXX
XXXXXXXXXXXXX  XXXXXX  XXXXXXXXXXXXXXXXXXXXXXXXXXXX  XXXXXX  XXXXXXXXX
XXXXXXXXXXXXXX  XXXX  XXXXXXXXXXXXXXXXXXXXXXXXXXXXXX  XXXX  XXXXXXXXXX
XXXXXXXXXXXXXXX  XX  XXXXXXXXXXXXXXXXXXXXXXXXXXXXXXXX  XX  XXXXXXXXXXX
XXXXXXXXXXXXXXXX    XXXXXXXXXXXXXXXXXXXXXXXXXXXXXXXXXX    XXXXXXXXXXXX
XXXXXXXXXXXXXXXXXXXXXXXXXXXXXXXXXXXXXXXXXXXXXXXXXXXXXXXXXXXXXXXXXXXXXX
