ENTER: ROW: 2, COL: 1
ENTER: ROW: 20, COL: 41
XXXXXXXXXXXXXXXXXXXXXXXXXXXXXXXXXXXXXXXXXXXXXXXXXXXXXXXXXXXXXXXXXXXXXX
          XXX                         XXXXXX  XXXX     XXXXXXXXXXXXXXX
XXXXXXXXX       XXXXXXXXXXXXXXXXXXXXX   XXXX   XX  XXX     XX   XXXXXX
XX   XXXXXXXXXXXXX XXXXXXXXXXXXXXXXXXXX     XX    XXXXXXXX    X  XXXXX
XX X             XXXXXXXXXXXXXXXXXXXXXXXXXX XXXXXX     XXXXXXXXX  XXXX
XX XXXXXXXXXXXX   XXXXXXXXXXXXXXXXXX          XXXXXXXX XXXXXXXXXX XXXX
XX XXXXXXXXXXXXXX  XXXXXXXXXXXXXXXXXXXXXXXXXX          XXXXXXXXXX XXXX
XX XXXXXXXXXXXXXXX                   XXXXXXXXXXXXXXXXX          X XXXX
XX XXXXXXXXXXXXXXXXXXXXXXXXXXXXXXXXX  XXXXXXXXXXXXXXXXXXXXXXXXX   XXXX
XX XXXXXXXXXXXXXXXXXXXXXX   XX        XXXXXXXXXXXXXXXX          XXXXXX
XX XXXXXXXXXXXXXXXXXXXX   X    XXXXXXXXXXXXXX          XXXXXXXXXXXXXXX
XX XXXX                 XXXXXXXXXXXX          XXXXXXXXXXXXXXXXXXXXXXXX
XX XXXX XXXXXXXXXXXXXXXXXXX          XXXXXXXXXXXXXXXXXXXXXXXXXXXXXXXXX
XX XXXX XXXXXXXXXX          XXXXXXXXXXXXXXXXXXXXXXXXXXXXXXXXXXXXXXXXXX
XX XXXX X          XXXXXXXXXXXXXXXXXXXXXXXXXXXXXXXXXXXXXXXXXXXXXXXXXXX
XX XXXX   XXXXXXXXXXXXXXXX                                           X
XX XXXXXXXXXXXXXXXXXXXXXXX XXXXXXXXXXXXXXXXXXXXXXXXXXXXXXXXXXXXXXXX  X
XX  X         XXXX         XXXXXXXXXXXXXXXXXXXXXXXXXXXXXXXXXXXXXXXXX X
XXX   XXXXXXX        XXXXXXXXXXXXXXXXXXXX                            X
XXXXXXXXXXXXXXXXXXXXXXXXXXXXXXXXXXXX      XXXXXXXXXXXXXXXXXXXXXXXXXXXX
